Grant-Jacobson|Christoph|Fiction
Bailey Group|Berk|Action
Raynor LLC|Daloris|Horror
Johnson, Baumbach and Denesik|Constantine|Comedy
Denesik and Sons|Wylma|Romance
Walsh-Funk|Kelly|Action
Gutkowski-Herzog|Rochell|Action
Lubowitz Group|Elsey|Romance
Beahan-Schmitt|Mallory|Romance
Wisoky-Bernier|Giuditta|Action
Ritchie and Sons|Greggory|Horror
Hirthe LLC|Joli|Action
Veum, Johns and Beatty|Guillema|Action
Fisher-Jakubowski|Miller|Romance
Wisozk Group|Tanner|Fiction
Barrows-Considine|William|Comedy
Zieme, Pfeffer and Mraz|Tansy|Fiction
Nolan, Collins and Runte|Maggy|Romance
Murphy-Skiles|Darin|Action
Berge, Fritsch and Oberbrunner|Rafaelia|Horror
Feest-Harvey|Roxana|Horror
Cronin-Kohler|Walton|Comedy
Muller-Champlin|Mignon|Fiction
Morissette LLC|Nigel|Comedy
Waelchi, Little and Nolan|Creigh|Action
Watsica Group|Karel|Action
Hettinger-Armstrong|Filide|Horror
Pfeffer-Sauer|Bourke|Comedy
Hirthe LLC|Faustina|Comedy
Koch, Howell and Oberbrunner|Geoffrey|Romance
Leannon-Stark|Jeniece|Comedy
Goyette, Witting and Schowalter|Andreana|Romance
Shields, Effertz and Heaney|Tobye|Action
Wehner-Koch|Morty|Action
Adams Group|Maribeth|Comedy
Ledner, Sawayn and Funk|Dinny|Romance
Walker, Simonis and Conroy|Deloris|Action
Waelchi-Hagenes|Morten|Comedy
Metz-Jacobson|Fred|Romance
Pfeffer-Olson|Kikelia|Action
Hills-Stracke|Aubert|Horror
Hettinger, Botsford and Skiles|Adam|Comedy
Schimmel Group|Ginnie|Fiction
Lockman, Green and Jerde|Fredi|Romance
Kunze and Sons|Sheilah|Romance
Legros-Harris|Britt|Romance
Lebsack Group|Ermanno|Comedy
Cole-Willms|Kitty|Fiction
Schumm, Dickens and Pfeffer|Noel|Action
Runolfsdottir-Kessler|Diane|Horror
Moore-Berge|Dale|Romance
Ernser Inc|Kaitlin|Horror
Stroman, Harris and Kuhlman|Karim|Comedy
Gusikowski, Wyman and Beahan|Darrel|Horror
Okuneva Inc|Violette|Action
Lakin Inc|Crin|Horror
Graham-Schulist|Blondelle|Comedy
Gerlach-Hegmann|Willow|Romance
Quigley-Fritsch|Pauly|Romance
Gusikowski-Lubowitz|Rakel|Comedy
King-Hyatt|Beryle|Fiction
Runolfsdottir-Bednar|Mil|Action
Moore and Sons|Ernst|Action
Predovic, Schaefer and Eichmann|Fraze|Action
Goodwin Inc|Jon|Fiction
Legros and Sons|Alfie|Romance
Roberts, Frami and Ebert|Kathlin|Action
Leuschke, Jacobson and Kuhic|Rhodie|Romance
Batz, Goldner and Greenfelder|Vail|Comedy
Little-Fadel|Juditha|Comedy
Strosin Inc|Joya|Action
Cronin, Kilback and West|Salmon|Action
Weimann, Jakubowski and Yost|Raleigh|Horror
Hansen LLC|Dahlia|Horror
Gutmann, Beier and Kris|Jarib|Romance
Huels, Abbott and Zulauf|Cherlyn|Fiction
Farrell Group|Susette|Horror
Russel and Sons|Ferdinande|Romance
Orn-Upton|Chery|Comedy
Mayert, Nienow and Harber|Naomi|Action
Emard, Sipes and Howe|Iseabal|Romance
Denesik, Zieme and Lehner|Anica|Action
Kohler Inc|Howey|Romance
Conn Group|Ricky|Comedy
Schuster-McLaughlin|Durant|Fiction
Haag Group|Karia|Comedy
Carroll-Wintheiser|Joly|Romance
O'Reilly-Bogisich|Lane|Romance
Dooley, Oberbrunner and Simonis|Reeta|Romance
Volkman-Funk|Margaretta|Fiction
Murazik and Sons|Kristen|Comedy
Koch and Sons|Samuel|Horror
Kris, Waters and Jones|Ralf|Romance
Effertz-Erdman|Ivie|Fiction
Wiza-Connelly|Heddie|Horror
Will Inc|Carolus|Romance
Fadel and Sons|Clive|Fiction
Cronin-Nitzsche|Patsy|Romance
Rath, Lowe and Lynch|Caren|Fiction
Stehr-Runolfsson|Boigie|Action
Wolff, Botsford and Beatty|Nicoline|Horror
Stamm-Corwin|Halsey|Comedy
Conroy Inc|Jaymie|Horror
Renner-Satterfield|Loraine|Action
Corwin LLC|Jerrilyn|Romance
Pfeffer-Nikolaus|Odelle|Comedy
Beier LLC|Lola|Action
Beer and Sons|Roarke|Fiction
Ebert-Rippin|Delainey|Comedy
Schuppe-Doyle|Fletcher|Romance
McKenzie-Wolf|Leia|Fiction
Weissnat-Ferry|Robbyn|Fiction
King, Walker and Powlowski|Rory|Comedy
Ullrich, Bergstrom and Johnston|Vaclav|Action
Fay, Sporer and Cartwright|Carr|Fiction
Anderson, Jenkins and Conn|Carree|Action
Pouros, Prosacco and O'Reilly|Guido|Fiction
Nitzsche, Smitham and Legros|Page|Fiction
Friesen, Barrows and Langworth|Alec|Horror
Toy, Heidenreich and Medhurst|Quintus|Action
Shanahan LLC|Myles|Action
Greenholt, Ullrich and Casper|Dorree|Horror
Raynor, DuBuque and Rippin|Donnie|Comedy
Labadie-Bailey|Wally|Fiction
Okuneva-Mraz|Brandy|Horror
Kassulke and Sons|Juliana|Fiction
Gerlach, Barton and Ferry|Tait|Romance
Lehner, Langosh and Kuvalis|Darn|Horror
Walter-Schaefer|Mart|Comedy
Stoltenberg and Sons|Zebadiah|Romance
Rippin-Bashirian|Keriann|Comedy
Goodwin-Kuhic|Sibylle|Romance
Lang-Ondricka|Killie|Romance
Brown Inc|Jacquelyn|Action
Herzog, Champlin and Kuphal|Walsh|Romance
Kovacek Inc|Normy|Fiction
Skiles, Rowe and Abernathy|Whitaker|Fiction
Conn-Wehner|Saunderson|Action
Sporer and Sons|Lay|Horror
Kohler and Sons|Arly|Fiction
Dickens, Spencer and Beatty|Penn|Action
Rowe-Shields|Nicolai|Horror
Smitham-Cronin|Julina|Horror
Mayer LLC|Elliott|Comedy
Balistreri-Ondricka|Cordell|Action
Kilback Inc|Roda|Comedy
Howe-Gislason|Gloriana|Horror
Kemmer and Sons|Blanca|Horror
Rodriguez-Brown|Arabel|Fiction
Bashirian Inc|May|Action
Emard, Terry and Wilderman|Paulo|Fiction
Weissnat-Denesik|Ciel|Horror
Cartwright-Gerhold|Merrielle|Romance
Kshlerin-Kautzer|Jackson|Comedy
Aufderhar, Glover and Spinka|Sophronia|Horror
Lueilwitz, Vandervort and Abernathy|Mindy|Comedy
West Inc|Loralyn|Romance
Stark-Schumm|Frasier|Comedy
Ziemann-Jakubowski|Shermie|Comedy
Green, Jones and Huel|Rodger|Fiction
Okuneva Inc|Anthiathia|Romance
Gislason-Mitchell|Esdras|Fiction
Jaskolski, Casper and Pfeffer|Adriano|Fiction
Rogahn, D'Amore and Rath|Piotr|Action
Moen-Fadel|Kore|Fiction
Leffler, Bashirian and Russel|Morlee|Comedy
Hane-Nolan|Dorey|Fiction
Durgan, Heller and Parisian|Karly|Fiction
Waelchi-Rolfson|Manya|Horror
Thompson-Kuvalis|Harlie|Horror
Satterfield-Reilly|Blanch|Comedy
Huel Inc|Fraser|Romance
Weissnat, Nader and West|Emalee|Horror
Quitzon-Ortiz|Gabrila|Horror
Rohan, Morar and Cremin|Charis|Fiction
Leffler, Wuckert and Ernser|Deborah|Fiction
Schuster-Swift|Alfy|Horror
Altenwerth-Grimes|Magdaia|Romance
Jast, Simonis and Schinner|Philomena|Romance
Spencer, Bernier and Tremblay|Mayne|Action
O'Keefe-McKenzie|Waldon|Romance
Prohaska Group|Celinda|Action
Morissette-Lubowitz|Jae|Action
Kshlerin, McClure and Runte|Tim|Action
Pfannerstill-Eichmann|Cordula|Horror
Batz Inc|Boigie|Romance
Shanahan LLC|Deeann|Action
Franecki, Rohan and Rolfson|Ermentrude|Romance
Koelpin, Greenfelder and Tremblay|Christalle|Comedy
West Group|Everard|Action
Terry, Thiel and Turner|Minni|Action
Hilll LLC|Fiona|Fiction
Parker, Rath and Ratke|Rosy|Horror
Murazik and Sons|Eleni|Horror
Dooley and Sons|Hyacinthe|Action
Larson, Jacobson and Hansen|Rollins|Comedy
Abbott Group|Sukey|Fiction
Altenwerth, McKenzie and Kerluke|Arch|Fiction
Hermiston, Lowe and Auer|Carmel|Comedy
Kulas and Sons|Em|Comedy
Macejkovic-Boehm|Christabella|Comedy
Kris, Kertzmann and Williamson|Avictor|Comedy
Emard LLC|Nannie|Comedy
Monahan, Schiller and O'Conner|Bobbie|Comedy
Mitchell LLC|Halsy|Comedy
Schaden, Steuber and Fadel|Calli|Horror
Ebert and Sons|Jasper|Comedy
Wilderman, Prosacco and Sawayn|Whitman|Romance
Block-Hilpert|Annamarie|Romance
Kerluke, O'Conner and Williamson|Bartlet|Romance
Mitchell-Kling|Philbert|Fiction
Buckridge, Lebsack and Streich|Evita|Comedy
Beer-Nitzsche|Morgana|Comedy
Ritchie Inc|Olly|Action
Larson-DuBuque|Ly|Romance
Rippin, Fisher and Maggio|Alexandro|Horror
Huels-Wolf|Alaine|Fiction
Dicki Inc|Urson|Horror
Hilll, Hand and Treutel|Melantha|Romance
Langworth Inc|Winston|Action
Kuhn Inc|Udale|Action
Klocko and Sons|Tally|Romance
Considine, Windler and Prosacco|Flori|Action
Rice-Hegmann|Chrysler|Romance
Schulist-Quigley|Jewelle|Romance
Ratke, VonRueden and Satterfield|Bernardine|Action
Ledner-Schneider|Taber|Horror
Mraz, Labadie and Keeling|Harv|Comedy
Koch Inc|Rube|Comedy
Larkin Group|Joseito|Comedy
Cummerata, Moore and Sporer|Marje|Horror
Howe-Durgan|Matthaeus|Comedy
Labadie-Bednar|Basilius|Fiction
Casper, Halvorson and Waters|Rogers|Romance
Hickle, Rempel and Witting|Quinton|Horror
Schiller, Yundt and Sipes|Papagena|Romance
Roberts LLC|Kyrstin|Action
Dare, Koss and Bernier|Jedediah|Comedy
Lueilwitz-Rohan|Haydon|Horror
Kiehn, Herzog and Huels|Riki|Fiction
Brekke and Sons|Christos|Romance
Hessel, Tromp and Oberbrunner|Martha|Romance
McCullough Inc|Lindsy|Romance
Walsh, Spinka and Wisozk|Augustin|Action
Prohaska and Sons|Finn|Comedy
Bode, Boyle and O'Reilly|Ker|Romance
Botsford and Sons|Latrena|Fiction
Osinski Group|Dylan|Comedy
Sanford Group|Murry|Romance
Pacocha-Huels|Gustavus|Romance
Satterfield Group|Ase|Comedy
Moore-Torp|Klarrisa|Horror
Wolf, Emard and Watsica|Mayer|Horror
Herman Inc|Berty|Horror
Kerluke Inc|Margy|Fiction
Beer Inc|Silvia|Horror
Volkman, Bailey and D'Amore|Sibylla|Comedy
Jerde, Hessel and Lehner|Antonin|Romance
McLaughlin-Cartwright|Gerri|Action
Zboncak-Hand|Ennis|Comedy
Stoltenberg Inc|Rory|Action
Kessler, Yost and Hills|Giorgia|Romance
Lind, Padberg and Lakin|Elston|Comedy
Farrell LLC|Theodora|Horror
Wuckert-Lemke|Salvidor|Fiction
Nolan Inc|Edd|Fiction
Klein Group|Verney|Action
Ratke-Kris|Myriam|Horror
Nikolaus Inc|Evie|Romance
West Inc|Joscelin|Comedy
Torp, Howe and Rippin|Ginger|Comedy
Morar Group|Olin|Comedy
Kerluke, Kemmer and Sanford|Beverly|Romance
Jast-Bernhard|De witt|Fiction
Jast Group|Andree|Action
Baumbach, Johnston and Olson|Lars|Fiction
Wintheiser, Muller and Nicolas|Joelly|Action
Hammes-Gerlach|Davide|Horror
Block LLC|Marcelo|Action
Lakin and Sons|Morissa|Comedy
Cassin Group|Collie|Fiction
Keeling-Davis|Joane|Romance
Abshire, Corkery and Wyman|Rosalia|Horror
Lindgren LLC|Ketti|Action
Spencer, Smitham and Prosacco|Linnie|Horror
Yost, Walter and Hackett|Dwight|Romance
Considine Group|Jeannette|Romance
Doyle LLC|Eleanora|Comedy
Krajcik, Rau and Wehner|Elbertina|Fiction
Bednar, Walker and Lakin|Tillie|Fiction
Feeney Inc|Galvin|Horror
Rowe LLC|Danette|Comedy
Batz-Kreiger|Olympia|Horror
Pacocha-Gleason|Charlotte|Fiction
Sauer-Mann|Janek|Horror
Walker-Fadel|Neall|Comedy
Ernser LLC|Gloria|Comedy
Dicki, Stark and Kemmer|Nolan|Action
Mertz LLC|Ambros|Fiction
Murray and Sons|Devland|Romance
Carroll, Kohler and Rutherford|Elladine|Romance
Torphy, Renner and Mohr|Zelda|Action
Hackett, Blanda and Krajcik|Errick|Action
Schmitt, Spencer and Mosciski|Shauna|Fiction
Reichel, Reichel and Franecki|Rip|Romance
Hickle, Jacobson and Effertz|Julina|Romance
Kulas-Schuster|Jere|Action
Dicki-Jacobson|Halette|Horror
Rippin and Sons|Jordanna|Horror
Dach and Sons|Grantham|Comedy
Nienow Inc|Eal|Action
Howe, Lockman and Tromp|Casper|Romance
Rodriguez and Sons|Adriana|Fiction
Hane, Beer and Lueilwitz|Orion|Comedy
Nitzsche LLC|Adlai|Romance
Hickle, Little and Abbott|Kelci|Horror
Heaney-Dickens|Stephannie|Romance
Skiles, Trantow and Stehr|Madeleine|Action
Zemlak, Prosacco and Rohan|Sterne|Horror
Hackett, Lemke and Ritchie|Jim|Comedy
Langosh-Rosenbaum|Shanna|Comedy
Jacobs, Senger and Howell|Janeva|Action
Ullrich-Wilkinson|Ambros|Fiction
Ortiz Inc|Anthony|Action
Hoppe-Ondricka|Jacquette|Comedy
Schuster Inc|Ina|Action
Pouros, Ullrich and Olson|Berrie|Horror
Welch, Bergstrom and Sawayn|Dolly|Action
Ortiz-Daugherty|Iain|Fiction
O'Reilly-Farrell|Margret|Romance
Cormier Group|Elli|Comedy
Schinner and Sons|Stevena|Romance
Abshire-Bailey|Morgan|Comedy
Schulist, Frami and Mann|Shelia|Action
Zulauf, Keeling and Pacocha|Jamie|Romance
Bahringer, O'Kon and Halvorson|Tamar|Action
Goodwin-Barton|Tomasina|Comedy
Morar-Shields|Clarance|Fiction
Beer, McGlynn and Mohr|Myrilla|Action
Leuschke, Douglas and Lueilwitz|Celisse|Horror
Hodkiewicz-Harris|Jaquelyn|Action
Runolfsdottir, Stamm and Corwin|Angelle|Comedy
Upton Inc|Stacia|Comedy
Wisozk, Goldner and Nolan|Loralee|Action
Lakin-Romaguera|Saxon|Action
Mosciski LLC|Judon|Romance
Bins-Collier|Don|Fiction
Klein-Collins|Dasi|Comedy
Koelpin, Mitchell and Parisian|Nelli|Horror
Hamill-Little|Ara|Comedy
Goldner, Stehr and Gleichner|Gladys|Action
Johnston and Sons|Liane|Action
Smitham and Sons|Palmer|Fiction
Sanford-Strosin|Ingaberg|Fiction
Bailey, Herzog and Rolfson|Philippe|Romance
Gerhold, Predovic and Abernathy|Riley|Horror
Bahringer-Stroman|Julieta|Horror
Feeney, Douglas and Oberbrunner|Blinnie|Comedy
Graham Group|Ilsa|Comedy
Cummings Group|Daniela|Fiction
Mertz-Harber|Dell|Comedy
Jacobi-Huels|Daphna|Comedy
Ziemann-Cruickshank|Wilfred|Action
Christiansen LLC|Mil|Action
Frami-O'Reilly|Rollie|Fiction
Stark LLC|Jerry|Romance
Bernhard, Treutel and McClure|Orlan|Romance
Vandervort and Sons|Suzie|Horror
Lemke, Renner and White|Dolly|Romance
Medhurst and Sons|Vince|Romance
Rolfson, Gerhold and Rodriguez|Reinaldos|Action
Hamill and Sons|Ferd|Fiction
Corkery-Jenkins|Eden|Fiction
Russel, Auer and Rodriguez|Javier|Action
Stanton, Prosacco and Nicolas|Morly|Action
Greenholt-Grady|Iris|Action
Haley-McDermott|Krispin|Fiction
Conroy, Kuhlman and Romaguera|Angie|Comedy
Ferry-Will|Sharl|Horror
Lang Inc|Guillema|Fiction
Rowe and Sons|Hank|Romance
Dickens-Wiza|Una|Romance
Hills Group|Juieta|Fiction
Schowalter-Rippin|Shep|Action
Legros and Sons|Kellina|Action
Erdman, Cruickshank and Welch|Ekaterina|Romance
Schneider, Ullrich and Kerluke|Clerissa|Comedy
Schaefer, Mohr and Miller|Kingsley|Romance
Reynolds Inc|Malorie|Horror
Cormier, Bradtke and Wolff|Mariana|Horror
Beahan and Sons|Alexandr|Romance
Abernathy-Reinger|Brandice|Comedy
Sauer-McGlynn|Liesa|Horror
Koss, Lowe and Goyette|Bertina|Horror
Wilkinson, Brown and Hegmann|Maurizia|Comedy
Ernser-Dibbert|Wynnie|Fiction
Hegmann, Hoeger and Schmidt|Latashia|Fiction
Wisoky-Schiller|Lemmie|Horror
Nikolaus and Sons|Margeaux|Action
Davis and Sons|Reese|Comedy
McDermott-Jast|Yovonnda|Romance
Schmidt, Quigley and Lang|Jaquenette|Action
Trantow, Halvorson and Morissette|Rosana|Comedy
Effertz-Beier|Esmeralda|Fiction
Wolf, Wolff and Torp|Leoine|Fiction
Pacocha-Spencer|Thornton|Comedy
Tillman LLC|Albertine|Horror
White-Bruen|Federico|Horror
Green-Gutkowski|Brittany|Horror
Bartell, Hauck and Wyman|Monique|Romance
Gulgowski-Batz|Vi|Romance
Morissette-Casper|Matty|Comedy
Langworth Inc|Bennie|Comedy
Mitchell-Swift|Salim|Action
Volkman, Pollich and Hagenes|Wernher|Fiction
Green and Sons|Fair|Horror
Wisozk Group|Paolina|Comedy
Ziemann-Schaden|Olive|Fiction
Hoppe-Harvey|Beniamino|Horror
Brakus, Dibbert and Powlowski|Ewen|Action
Schulist, Herman and Davis|Stoddard|Action
Prosacco Inc|Tera|Romance
Schuster-Langosh|Yorke|Horror
Armstrong and Sons|Jayme|Fiction
Senger Group|Nathanial|Comedy
VonRueden Inc|Afton|Romance
Swift Group|Sib|Horror
Weimann Inc|Raye|Action
Feil-Auer|Rafferty|Action
Koelpin-Simonis|Wayland|Action
Glover-Volkman|Nap|Romance
Cremin-Pagac|Donaugh|Action
Abbott and Sons|Kesley|Horror
Hammes Group|Forest|Comedy
Grant-Vandervort|Emmery|Comedy
Bayer LLC|Brnaby|Comedy
Marvin, Thompson and Legros|Sherlocke|Horror
Kemmer Group|Nana|Comedy
Borer and Sons|Athena|Action
Tromp Group|Thorsten|Horror
Spencer, Christiansen and Ebert|Orelie|Horror
Kilback and Sons|Lin|Horror
Considine, Labadie and Robel|Shanan|Romance
Hermann-Murphy|Austin|Action
Hills, Abshire and Zulauf|Laure|Fiction
Kshlerin LLC|Pavlov|Action
Bauch, Stokes and Kub|Marianna|Action
Stiedemann-Swaniawski|Erinn|Horror
Labadie LLC|Alexandra|Action
Farrell, Block and Bernhard|Carlin|Romance
Gorczany-Von|Minta|Horror
Rippin, Cummerata and Yundt|Aloysia|Action
Gerlach-Leffler|Holli|Horror
Ernser Group|Paddy|Action
Bauch Group|Sigismundo|Fiction
Ledner LLC|Maxie|Fiction
King LLC|Sal|Horror
Price and Sons|Nicki|Horror
Schuster, Stoltenberg and Willms|Hewitt|Romance
Rutherford, Hettinger and Macejkovic|Gwyneth|Horror
Lesch, Hettinger and Runolfsson|Daffy|Horror
Trantow-Russel|Donelle|Horror
Balistreri and Sons|Ellie|Romance
Denesik-Borer|Farr|Action
Brown-Cartwright|Lyle|Action
Batz, Schmitt and O'Conner|Phyllis|Horror
Mertz, Nienow and Bergnaum|Artemus|Action
Roob, Lockman and O'Conner|Woodrow|Comedy
Smith, Treutel and Sauer|Reider|Horror
D'Amore, Kreiger and Harris|Zena|Horror
Bailey Inc|Hill|Fiction
Stroman-Tillman|Charlie|Fiction
Kessler-Connelly|Garvin|Fiction
Dare Inc|Sauncho|Romance
Mayer-Graham|Anabella|Action
Walter-Lesch|Keslie|Action
Marquardt Inc|Joni|Horror
VonRueden Inc|Venita|Comedy
Tremblay Group|Brannon|Horror
Lockman, Huels and Deckow|Dayna|Action
Buckridge, Prohaska and Bartell|Jerome|Romance
Wiza LLC|Samuele|Comedy
Tromp-Ortiz|Alisa|Fiction
Mertz-Franecki|Robby|Fiction
Roob-Tremblay|Dael|Romance
Braun, Frami and Romaguera|Ermanno|Romance
Berge, Smitham and Kuhic|Shaughn|Romance
Kreiger Inc|Jamil|Romance
Abshire Inc|Laney|Comedy
Kunze, Volkman and Bergnaum|Debora|Horror
Kulas-Rutherford|Gilberta|Horror
Weissnat, McCullough and Walker|Addie|Horror
Hane, Torp and Gutkowski|Brooke|Romance
Fritsch Group|Creight|Fiction
Macejkovic and Sons|Galen|Horror
Batz Inc|Flemming|Romance
Schiller LLC|Valerye|Action
Christiansen-Tillman|Kurtis|Fiction
Balistreri, Dietrich and McCullough|Khalil|Horror
Crooks, Kovacek and Green|Saba|Romance
